111111111111111111111111111111
1110C00000C00000C00000C00000C1
110000100E00010000001000000101
10C000C000C000C000C000C000C001
1C000C000C000C000C000C000C0001
1C000C000C000C000C000C000C00P1
111111111111111111111111111111