1111111111
1110C00P01
1100001E01
1111111111